1,2,1,2,1,2,1,2,1,2,1,2,1,2,1,2,1,2,1,2,1,2,1,2,1,2,1,2,1,2,1,2,
17,18,17,18,17,18,17,18,17,18,17,18,17,18,17,18,17,18,17,18,17,18,17,18,17,18,17,18,17,18,17,18,
1,2,0,0,0,0,0,0,0,0,0,0,0,0,0,0,0,0,0,0,0,0,0,0,0,0,0,0,0,0,1,2,
17,18,0,0,0,0,0,0,0,0,0,0,0,0,0,0,0,0,0,0,0,0,0,0,0,0,0,0,0,0,17,18,
1,2,0,0,0,0,0,0,0,0,0,0,0,0,0,0,0,0,0,0,0,0,0,0,0,0,0,0,0,0,1,2,
17,18,0,0,0,0,0,0,0,0,0,0,0,0,0,0,0,0,0,0,0,0,0,0,0,0,0,0,0,0,17,18,
1,2,0,0,0,0,0,0,0,0,0,0,0,0,0,0,0,0,0,0,0,0,0,0,0,0,0,0,0,0,1,2,
17,18,0,0,0,0,0,0,0,0,0,0,0,0,0,0,0,0,0,0,0,0,0,0,0,0,0,0,0,0,17,18,
1,2,0,0,0,0,0,0,0,0,0,0,0,0,0,0,0,0,0,0,0,0,0,0,0,0,0,0,0,0,1,2,
17,18,0,0,0,0,0,0,0,0,0,0,0,0,0,0,0,0,0,0,0,0,0,0,0,0,0,0,0,0,17,18,
1,2,0,0,0,0,0,0,0,0,0,0,0,0,0,0,0,0,0,0,0,0,0,0,0,0,0,0,0,0,1,2,
17,18,0,0,0,0,0,0,0,0,0,0,0,0,0,0,0,0,0,0,0,0,0,0,0,0,0,0,0,0,17,18,
1,2,0,0,0,0,0,0,0,0,0,0,0,0,0,66,0,0,0,0,0,0,0,0,0,0,0,0,0,0,1,2,
17,18,0,0,0,0,0,0,0,0,0,0,0,0,0,50,0,0,0,0,0,0,0,0,0,0,0,0,0,0,17,18,
1,2,0,0,0,0,0,0,0,0,0,0,0,0,0,35,0,0,0,0,0,0,0,0,0,0,0,0,0,0,1,2,
17,18,0,0,0,0,0,0,0,66,0,0,0,0,0,51,0,0,0,0,0,0,0,0,0,0,0,0,0,0,17,18,
1,2,0,0,0,0,0,0,0,1,4,65,65,65,65,34,0,0,0,0,0,0,0,0,0,0,0,0,0,0,1,2,
17,18,0,0,0,0,0,0,0,19,20,0,0,0,0,68,0,0,0,0,0,0,0,0,0,0,0,0,0,0,17,18,
1,2,0,0,0,0,0,0,0,69,36,0,0,0,0,51,0,0,0,0,0,66,0,0,0,0,0,0,0,0,1,2,
17,18,0,0,0,0,0,0,0,35,0,0,0,0,3,33,65,65,65,65,1,4,0,0,0,0,0,0,0,0,17,18,
1,2,0,0,0,0,0,0,0,67,0,0,0,53,19,49,0,0,0,0,19,20,0,0,0,0,0,0,0,0,1,2,
17,18,0,0,0,0,0,0,66,68,0,0,0,1,36,0,0,0,0,0,19,18,0,0,0,0,0,0,0,0,17,18,
1,2,0,0,0,0,0,53,33,34,0,0,0,19,0,0,0,0,0,0,19,20,65,65,3,4,0,0,0,0,1,2,
17,18,52,0,0,33,65,65,49,50,0,0,0,19,2,65,65,65,65,65,19,18,0,0,17,20,0,0,0,0,17,18,
1,2,65,65,65,49,0,0,0,35,0,0,0,19,20,0,0,0,0,0,35,0,0,0,0,35,0,0,0,66,1,2,
17,18,0,0,0,0,0,0,0,67,0,66,0,51,68,0,0,66,0,0,51,0,0,0,0,68,0,0,66,66,17,18,
1,2,1,2,1,2,1,2,1,2,1,2,1,2,1,2,1,2,1,2,1,2,1,2,1,2,1,2,1,2,1,2,
17,18,17,18,17,18,17,18,17,18,17,18,17,18,17,18,17,18,17,18,17,18,17,18,17,18,17,18,17,18,17,18
